WWWWWWW
W_____W
W_PBG_W
W_____W
WWWWWWW